-18
18
-13
11
0000000000000000000000000000000000000
1111111111111111111111111111111111111
0000000000000000000000000000000000001
0000000000000000000000000000000000001
0000000000000000000000000000000000001
0000011111111110000000000000000000001
0000011111111111111100000000000000001
0000000011111110000000000000000000001
0000011111111110000000000000000000001
0000011111101110000000000000000000001
0001111111101110000000000000000000001
0000000000000000000000000000000000001
0000000000000000000000000000000000001
0000000000000000000000000000000000001
0000000000000000000000000000000000001
0000000000000000000000000000000000001
0000000000000000000000000000000000001
0000000000000000000000000000000000001
0000000000000000000000000000000000001
0000000000000000000000000000000000001
0000000000000000000000000000000000001
0000000000000000000000000000000000001
0000000000000000000000000000000000001
0000000000000000000000000000000000001
1111111111111111111111111111111111111
