-15
13
-3
7
00000000000000000000000000000
00111111111100000000000000000
00111111111111111000000000000
00000111111100000000000000000
00111111111100010000000011110
00111111011101001000000000000
11111111011100000000000000000
00000000000000000000000000000
00000000000010001000000000000
00000000000000000000000000000
00000000000010001000000000000
