-40
30
-21
15
10000000000000000000000000000000000000000000000000000000000000001000000
10000000000000000000000000000000000000000000000000000000000000001000000
10000000000000000000000000000000000000000000000000000000000000001000000
10000000000000000000000000000000000000000000000000000000000000001000000
10000000000000000000000000000000000000000000000000000000000000001000000
10000000000000000000000000000000000000000000000000000000000000001000000
10000000000000000000000000000000000000000000000000000000000000001000000
10000000000000000000000000000111111100000000000000000000000000001000000
10000000000000000000000000000111111100000000000000000000000000001000000
10000000000000000000000000000111111100000000010000000000000000001000000
10000000000000000000000000000111110100000000000000100000000000001000000
10000000000000000000000000000111111100000000000000000000000000001000000
10000000000000000000000000000101011100000000000010101000000000001000000
10000000000000000000000000000111011100000000000000000000000000001000000
10000000000000000000000000000001010000000000000010101000000000001000000
10000000000000000000000000000001010000000000000000000000000000001000000
10000000000000001000000000000001010000000000000010101000000000001000000
10000000000000000000001000000000000000000000000000000000000000001000000
10000000000000000000000000000000000000000000000000000000000000001000000
10000000000000000000010000000000000000000000000000000000000000001000000
10000000000000000000000000000000000000000000000000000000000000001000000
10000000000000000000000000000000000000000000000000000000000000001000000
10000000000000000000000000000001110000000000000000000000000000001000000
10000000000000000000000000000001110000000000000000000000000000001000000
10000000000000000000000000000001110000000000000000000000000000001000000
10000000000000000000000000000000000000000000000000000000000000001000000
10000000000000000000000000000000000000000000000000000000000000001000000
10000000000000000000000000000000000000000000000000000000000000001000000
10000000000000000000000000000000000000000000000000000000000000001000000
10000000000000000000000000000000000000000000000000000000000000001000000
10000000000000000000000000000000000000000000000000000000000000001000000
10000000000000000000000000000000000000000000000000000000000000001000000
11111111111111111111111111111111111111111111111111111111111111111000000
00000000011111000000000111110000000000000000000011111100000000000000000
00000000000000000000000000000000000000000000000000000000000000000000000
00000000000000000000000000000000000000000000000000000000000000000000000
00000000000000000000000000000000000000000000000000000000000000000000000
